###############
## O        ###
##          ###
##           ##
##$         O##
####        ###
####         ##
###         O##
##$      ######
###############