###############
## O        $##
##          ###
###          ##
###$        O##
##         ####
####         ##
###          ##
####$      ####
###############