###############
##O  ##########
##       ######
###         $##
###          ##
#O           ##
###          ##
###          ##
######     ####
###############